id,start_chrom,start,end_chrom,end,ref,alt,length,brackets,type_inferred
166_1,1,67452229,1,67452635,N,[1:67452635[N,406,[N,INV
275,1,118091051,1,118091258,N,<DEL>,207,N[,DEL
367,1,182884306,1,182884320,N,<DEL>,14,N[,DEL
370_1,1,186826187,1,186826404,N,N]1:186826404],217,N],INV
606,2,27313898,2,27314025,N,<DEL>,127,N[,DEL
649,2,35576937,2,35576964,N,<DEL>,27,N[,DEL
756,2,88429841,2,88430152,N,<DEL>,311,N[,DEL
855,2,129550225,2,129550253,N,<DEL>,28,N[,DEL
1036,2,224699787,2,224699797,N,<DEL>,10,N[,DEL
1068,2,236378717,2,236378743,N,<DEL>,26,N[,DEL
1097,2,241726086,2,241726119,N,<DEL>,33,N[,DEL
1105,2,242411342,2,242411522,N,<DEL>,180,N[,DEL
1125,3,6162950,3,6163041,N,<DEL>,91,N[,DEL
1132,3,7905948,3,7906150,N,<DEL>,202,N[,DEL
1166,3,26450970,3,26452298,N,<DEL>,1328,N[,DEL
